1111111111111111111111111111111111
1P000000001100001111C0000000001C01
1000011000000000001111000000001001
1100000000001110000011110000001001
1011111000000000000000000011111001
1000000001110000000000000000000001
1000011111000000000011110000000001
1000000000000000000001111000000001
1000000111111000000001111000000001
1000000000001111000000111100000001
1000000000000000000000000000000001
1000111110001111000000000111100001
1000000000000001111000000000000001
100001111100000000E111000000000001
10000000C1000011111100000111100001
10000011110000000000C0000000000001
1111111111111111111111111111111111