111111111111
100000C00001
1E0000000001
100000000001
100000000000
111111111111