111111111111
1P00000E0001
100000000001
100000000001
100000000001
111111111111