111111111111111111111111111111
1P0000000000000000000000000001
100000000000C000000001111C0001
100000011111110000000000000001
1000000000100000000000000000E1
111111111111111111111111111111