111111111111111111111111111111111111111111111111111111111111111111111111111111
1P0000C000E0000000000000000000000000000000000000000000100000000001000000000011
100000000001000000000010000000000100000000001000000000010000000000100000000001
100000000000000000000000000000000000000000000000000000100000000001000000000011
100000000001000000000010000000000100000000001000000000010000000000100000000001
100000000001000000000010000000000100000000001000000000010000000000100000000001
100000000000000000000000000000000000000000000000000000100000000001000000000011
100000000001000000000010000000000100000000001000000000010000000000100000000001
100000000001000000000010000000000100000000001000000000010000000000100000000001
100000000000000000000000000000000000000000000000000000100000000001000000000011
100000000001000000000010000000000100000000001000000000010000000000100000000001
100000000001000000000010000000000100000000001000000000010000000000100000000001
100000000000000000000000000000000000000000000000000000100000000001000000000011
100000000001000000000010000000000100000000001000000000010000000000100000000001
100000000001000000000010000000000100000000001000000000010000000000100000000001
100000000000000000000000000000000000000000000000000000100000000001000000000011
100000000001000000000010000000000100000000001000000000010000000000100000000001
100000000001000000000010000000000100000000001000000000010000000000100000000001
100000000001000000000010000000000100000000001000000000010000000000100000000001
100000000000000000000000000000000000000000000000000000100000000001000000000011
100000000001000000000010000000000100000000001000000000010000000000100000000001
100000000001000000000010000000000100000000001000000000010000000000100000000001
100000000000000000000000000000000000000000000000000000100000000001000000000011
100000000001000000000010000000000100000000001000000000010000000000100000000001
100000000001000000000010000000000100000000001000000000010000000000100000000001
100000000000000000000000000000000000000000000000000000100000000001000000000011
100000000001000000000010000000000100000000001000000000010000000000100000000001
100000000001000000000010000000000100000000001000000000010000000000100000000001
100000000001000000000010000000000100000000001000000000010000000000100000000001
100000000000000000000000000000000000000000000000000000100000000001000000000011
100000000001000000000010000000000100000000001000000000010000000000100000000001
100000000001000000000010000000000100000000001000000000010000000000100000000001
100000000000000000000000000000000000000000000000000000100000000001000000000011
100000000001000000000010000000000100000000001000000000010000000000100000000001
100000000001000000000010000000000100000000001000000000010000000000100000000001
100000000000000000000000000000000000000000000000000000100000000001000000000011
100000000001000000000010000000000100000000001000000000010000000000100000000001
111111111111111111111111111111111111111111111111111111111111111111111111111111